#########################################################################################################
#       #               #               #               #                                               #
#       #               #               #               #                                               #
#       #               #               #               #                                               #
#       #       #       #########       #       #       #       #################       #########       #
#       #       #               #               #       #       #                       #               #
#       #       #               #               #       #       #                       #               #
#       #       #               #               #       #       #                       #               #
#       #       #########       #################       #       #########################       #########
#       #       #               #                       #                               #               #
#       #       #               #                       #                               #               #
#       #       #               #                       #                               #               #
#       #       #       #################       #################################       #       #########
#               #                                                                       #               #
#               #                                                                       #               #
#               #                                                                       #               #
#################       #################################       #################################       #
#               #       #                                       #               #                       #
#               #       #                                       #               #                       #
#               #       #                                       #               #                       #
#       #########       #       #################################       #       #########################
#                       #                                               #       #                       #
#                       #                                               #       #                       #
#                       #                                               #       #                       #
#########################       #########################################       #       #       #########
#       #               #                       #                               #       #               #
#       #               #                       #                               #       #               #
#       #               #                       #                               #       #               #
#       #       #       #########       #       #       #################################       #       #
#               #                       #       #                                               #       #
#               #                       #       #                                               #       #
#               #                       #       #                                               #       #
#########################################################################################################
