#############################################################
#                             #                   #         #
#                             #                   #         #
#                             #                   #         #
#                             #                   #         #
#                             #                   #         #
#                             #                   #         #
#                             #                   #         #
#                             #                   #         #
#                             #                   #         #
#####################         #         #         #         #
#                             #         #                   #
#                             #         #                   #
#                             #         #                   #
#                             #         #                   #
#                             #         #                   #
#                             #         #                   #
#                             #         #                   #
#                             #         #                   #
#                             #         #                   #
#         #####################         #         ###########
#                                       #                   #
#                                       #                   #
#                                       #                   #
#                                       #                   #
#                                       #                   #
#                                       #                   #
#                                       #                   #
#                                       #                   #
#                                       #                   #
#############################################################
