#############################################################
#         #                                                 #
#         #                                                 #
#         #                                                 #
#         #                                                 #
#         #                                                 #
#         #                                                 #
#         #                                                 #
#         #                                                 #
#         #                                                 #
#         #         ###############################         #
#                   #                                       #
#                   #                                       #
#                   #                                       #
#                   #                                       #
#                   #                                       #
#                   #                                       #
#                   #                                       #
#                   #                                       #
#                   #                                       #
#####################         #####################         #
#                             #                             #
#                             #                             #
#                             #                             #
#                             #                             #
#                             #                             #
#                             #                             #
#                             #                             #
#                             #                             #
#                             #                             #
#############################################################
