#############################################################
#         #                             #                   #
#         #                             #                   #
#         #                             #                   #
#         #                             #                   #
#         #                             #                   #
#         #                             #                   #
#         #                             #                   #
#         #                             #                   #
#         #                             #                   #
#         #         ###########         #         #         #
#         #         #         #                   #         #
#         #         #         #                   #         #
#         #         #         #                   #         #
#         #         #         #                   #         #
#         #         #         #                   #         #
#         #         #         #                   #         #
#         #         #         #                   #         #
#         #         #         #                   #         #
#         #         #         #                   #         #
#         #         #         #####################         #
#                   #                                       #
#                   #                                       #
#                   #                                       #
#                   #                                       #
#                   #                                       #
#                   #                                       #
#                   #                                       #
#                   #                                       #
#                   #                                       #
#############################################################
