#############################################################
#         #                             #                   #
#         #                             #                   #
#         #                             #                   #
#         #                             #                   #
#         #                             #                   #
#         #                             #                   #
#         #                             #                   #
#         #                             #                   #
#         #                             #                   #
#         #         ###########         #         #         #
#         #         #                   #         #         #
#         #         #                   #         #         #
#         #         #                   #         #         #
#         #         #                   #         #         #
#         #         #                   #         #         #
#         #         #                   #         #         #
#         #         #                   #         #         #
#         #         #                   #         #         #
#         #         #                   #         #         #
#         #         #         #####################         #
#                   #                                       #
#                   #                                       #
#                   #                                       #
#                   #                                       #
#                   #                                       #
#                   #                                       #
#                   #                                       #
#                   #                                       #
#                   #                                       #
#############################################################
